10
11
11111111101
10001000101
10101010101
10101010101
10101010101
10101010101
10101010101
10101010101
10100010001
10111111111